NO ./textures/north.xpm
SO ./textures/south.xpm
WE ./textures/west.xpm
EA ./textures/east.xpm
F 0,0,0
C 255,255,255

        111111
        100001
111111111000011111
100000000S00000001
111111111000011111
        100001
        111111